
R  900 400 
NO ./textures/brick.xpm
SO ./textures/stone.xpm
WE ./textures/cave.xpm
EA ./textures/wood.xpm

S ./textures/guard.xpm

F 0,100,0
C 7,124,219

        1111111111111111111111111  
        1000000000110000002002001
        1011000001110000000000001
        1001000000000000000000001
111111111011000001110000000000001
100000000011000001110111100011111
11110111111111011100000010001
11110111111111011101010010201
11000000110101011100000010001
10020000000000001100000010001
10000000000000000001010000001
11000001110101011111011110N0111
11110111 1110101 101111010001
11111111 1111111 111111111111