
R 1200 800
			NO 		./textures/brick.xpm  
SO ./textures/cave.xpm
WE ./textures/stone.xpm
EA  ./textures/wood.xpm
S		./textures/guard.xpm
F 0,100,0
 C 7,124,219

        1111111111111111111111111  
        1000000000110000010000001
        1011000001110000002002001
        1001000000000000000000001
111111111011000001110000000000001
100000000011000001110111111111111
11110111111111011100000010001
11110111111111011101010010201
11000000110101011100000010001
10020000000000001100000010001
10000000000000000000000000N01
1100000111010101111101111000111
11111111 1111111 111111111111